1111111111111111111111111111
1P00000000000110000000000001
1011110111110110111110111101
1011110111110110111110111101
1011110111110110111110111101
1000000000000000000000000001
1011110110111111110110111101
1011110110111111110110111101
1000000110000110000110000001
1000000111110110111110000001
1000000111110110111110000001
1000000110000000000110000001
1000000110000000000110000001
1000000110000000000110000001
1000000000C0B0I0p00000000001
1000000110000000000110000001
1000000110000000000110000001
1000000110000000000110000001
1000000110000000000110000001
1000000110111111110110000001
1000000110111111110110000001
1000000000000110000000000001
1011110111110110111110111101
1011110111110110111110111101
1000110000000000000000110001
1110110110111111110110110111
1110110110111111110110110111
1000000110000110000110000001
1011111111110110111111111101
1011111111110110111111111101
1000000000000000000000000001
1111111111111111111111111111
