1111111111111111111111111111
1P00000000000110000000000001
1011110111110110111110111101
1S111101111101101111101111S1
1011110111110110111110111101
100000000000000p000000000001
1011110110111111110110111101
1011110110111111110110111101
1000000110000110000110000001
1000000111110110111110000001
1000000111110110111110000001
1000000110000000000110000001
1000000110000000000110000001
1000000110000000000110000001
100000000000B00I000000000001
1000000110000000000110000001
10000001100000C0000110000001
1000000110000000000110000001
1000000110000000000110000001
1000000110111111110110000001
1000000110111111110110000001
1000000000000110000000000001
1011110111110110111110111101
1011110111110110111110111101
1S001100000000000000001100S1
1110110110111111110110110111
1110110110111111110110110111
1000000110000110000110000001
1011111111110110111111111101
1011111111110110111111111101
1000000000000000000000000001
1111111111111111111111111111
