11111111111
1P000000001
10000000001
10000000001
1000CBpI001
10000000001
10000000001
10000000001
10000000001
10000000001
10000000001
11111111111
