1111111111111111111111111111
1000000100000001111011000001
1111100100011001111011000001
1000000000011001111000111111
1111000110000000000000000001
1111000110000000000000111111
1111011111100000111110111111
1000011111100000111110000001
1000000110000000111110111111
1000000110000000111110111111
1000000110000000000000111111
1000000110000000000000111111
1000011111110000000000111111
1000011111110000000000000001
1000000000000000000000000001
1000000000000000000000000001
1111111111111111111111111111
